1
1 1 1 1 1 1 1 1 1 1 1 1 1
1 10 0 12 34 31 34 0 0 0 0 0 1
1 2 2 2 2 2 2 2 2 2 2 0 1
1 6 0 32 4 0 2 6 27 7 2 0 1
1 12 32 16 2 0 2 6 12 7 2 0 1
1 2 4 2 2 0 2 2 2 30 2 0 1
1 12 37 6 2 0 4 47 34 35 2 0 1
1 17 0 14 2 0 2 2 2 2 2 0 1
1 2 4 2 2 0 0 0 0 0 0 0 1
1 6 37 6 2 2 3 2 2 2 4 2 1
1 6 46 12 2 13 0 16 2 12 38 14 1
1 6 8 12 2 0 11 0 2 12 12 12 1
1 1 1 1 1 1 1 1 1 1 1 1 1

2
1 1 1 1 1 1 1 1 1 1 1 1 1
1 11 2 0 40 0 2 16 17 12 13 2 1
1 0 2 17 2 7 2 16 17 12 14 2 1
1 0 2 12 2 12 2 16 17 12 41 2 1
1 0 2 12 2 12 2 2 2 2 4 2 1
1 0 2 0 2 0 0 0 4 0 0 2 1
1 0 2 4 2 2 4 2 2 4 2 2 1
1 0 20 0 0 0 0 2 0 41 0 2 1
1 0 2 4 2 2 5 2 0 2 0 2 1
1 0 2 12 2 7 6 2 0 2 0 2 1
1 0 2 12 2 7 6 2 0 2 0 2 1
1 10 2 16 2 7 6 2 21 2 25 2 1
1 1 1 1 1 1 1 1 1 1 1 1 1

3
1 1 1 1 1 1 1 1 1 1 1 1 1
1 21 31 12 2 22 -2 -1 2 2 2 2 1
1 31 12 6 2 0 0 0 2 0 35 0 1
1 12 32 6 2 2 4 2 2 0 2 0 1
1 2 4 2 2 0 32 7 2 12 2 31 1
1 0 0 0 2 2 2 0 2 12 2 35 1
1 34 2 0 35 31 35 0 2 12 2 31 1
1 34 2 2 2 2 2 0 0 0 2 0 1
1 0 0 0 0 0 2 2 4 2 2 0 1
1 2 2 2 2 35 2 31 0 31 2 0 1
1 2 0 0 0 0 2 17 45 12 2 0 1
1 11 0 2 2 2 2 16 7 12 2 10 1
1 1 1 1 1 1 1 1 1 1 1 1 1

4
1 1 1 1 1 1 1 1 1 1 1 1 1
1 0 30 0 2 0 23 0 2 0 30 0 1
1 4 2 4 2 0 0 0 2 4 2 4 1
1 0 2 0 2 2 0 2 2 0 2 0 1
1 0 2 32 2 38 45 38 2 32 2 0 1
1 35 2 6 2 17 38 17 2 6 2 35 1
1 35 2 6 2 2 3 2 2 6 2 35 1
1 31 2 0 2 36 39 36 2 0 2 31 1
1 0 2 0 2 16 36 16 2 0 2 0 1
1 0 2 0 2 2 5 2 2 0 2 0 1
1 0 2 0 2 12 0 12 2 0 2 0 1
1 10 2 0 30 0 0 0 30 0 2 11 1
1 1 1 1 1 1 1 1 1 1 1 1 1

5
1 1 1 1 1 1 1 1 1 1 1 1 1
1 24 2 6 2 7 33 0 0 33 12 14 1
1 0 2 16 2 33 0 0 0 0 33 12 1
1 38 2 0 2 37 0 2 2 4 2 2 1
1 0 4 33 2 25 37 2 0 36 37 19 1
1 38 2 0 2 2 2 2 0 0 0 37 1
1 16 2 0 0 0 35 32 0 0 0 0 1
1 17 2 2 30 2 2 2 2 0 0 0 1
1 0 18 2 30 2 0 0 0 36 39 0 1
1 2 2 2 35 2 4 2 5 2 4 2 1
1 0 0 2 0 2 35 2 17 4 0 2 1
1 11 0 35 0 0 0 2 12 2 10 2 1
1 1 1 1 1 1 1 1 1 1 1 1 1

6
1 1 1 1 1 1 1 1 1 1 1 1 1
1 26 42 2 17 2 12 43 27 2 7 7 1
1 42 12 2 16 2 0 12 43 2 44 7 1
1 12 45 5 0 5 45 0 12 2 0 44 1
1 0 0 2 39 2 0 0 0 2 46 0 1
1 2 2 2 3 2 2 2 2 2 4 2 1
1 0 0 47 0 12 12 12 0 47 0 0 1
1 0 2 2 2 2 2 2 2 2 2 2 1
1 0 2 38 4 38 0 0 0 0 0 2 1
1 0 2 4 2 4 2 2 2 2 5 2 1
1 0 2 38 2 0 0 2 2 0 0 2 1
1 0 0 0 2 10 0 4 4 0 11 2 1
1 1 1 1 1 1 1 1 1 1 1 1 1

7
1 1 1 1 1 1 1 1 1 1 1 1 1
1 10 0 0 0 0 0 0 0 2 2 2 1
1 2 2 0 45 2 5 2 42 0 2 2 1
1 2 0 45 17 2 48 2 16 42 0 2 1
1 0 0 2 2 2 0 2 2 2 0 0 1
1 0 0 5 48 0 28 0 48 5 0 0 1
1 0 2 2 2 2 0 2 2 2 2 0 1
1 0 2 6 16 2 48 2 17 6 2 0 1
1 0 2 12 6 2 5 2 6 12 2 0 1
1 0 2 2 14 14 7 14 14 2 2 0 1
1 0 0 2 2 2 3 2 2 2 0 0 1
1 2 0 0 4 11 0 0 4 0 0 2 1
1 1 1 1 1 1 1 1 1 1 1 1 1

8
1 1 1 1 1 1 1 1 1 1 1 1 1
1 11 2 0 0 0 0 2 0 12 42 0 1
1 0 2 0 2 2 4 2 4 2 2 0 1
1 0 2 0 2 0 0 5 0 0 2 16 1
1 0 2 0 2 49 2 2 2 38 2 30 1
1 38 2 0 2 6 2 10 0 0 2 30 1
1 45 2 17 2 6 2 2 2 2 2 0 1
1 38 2 30 2 0 0 0 2 0 45 0 1
1 0 2 30 2 2 2 39 2 4 2 2 1
1 0 2 0 42 0 2 42 2 0 0 0 1
1 0 2 2 2 4 2 0 2 2 2 0 1
1 0 0 49 0 0 2 0 43 48 43 0 1
1 1 1 1 1 1 1 1 1 1 1 1 1

9
1 1 1 1 1 1 1 1 1 1 1 1 1
1 9 12 0 2 2 2 0 0 0 2 0 1
1 12 0 50 4 0 0 0 2 0 4 42 1
1 2 4 2 2 0 2 2 2 0 2 12 1
1 0 0 0 2 0 2 0 0 0 2 12 1
1 0 0 0 3 0 2 11 2 0 2 6 1
1 2 5 2 2 0 2 2 2 0 2 2 1
1 17 46 16 2 49 2 10 2 0 2 6 1
1 2 4 2 2 0 0 0 4 0 2 12 1
1 42 6 42 2 2 5 2 2 0 2 12 1
1 14 42 6 2 44 49 44 2 0 4 42 1
1 21 14 42 4 7 44 7 2 0 2 0 1
1 1 1 1 1 1 1 1 1 1 1 1 1

10
1 1 1 1 1 1 1 1 1 1 1 1 1
1 0 2 2 17 50 2 50 16 2 2 0 1
1 0 0 2 2 4 2 4 2 2 0 46 1
1 0 0 0 0 0 2 0 0 0 46 7 1
1 0 2 0 2 2 2 2 2 0 2 2 1
1 38 2 0 0 12 12 12 0 0 2 12 1
1 45 2 0 2 2 2 2 4 2 2 12 1
1 38 2 0 0 0 11 2 0 4 45 0 1
1 0 2 2 2 2 2 2 4 2 2 0 1
1 0 2 6 17 16 2 0 45 0 2 12 1
1 0 2 6 17 16 3 49 2 49 2 12 1
1 10 2 6 17 16 2 14 2 14 2 6 1
1 1 1 1 1 1 1 1 1 1 1 1 1

11
1 1 1 1 1 1 1 1 1 1 1 1 1
1 6 2 12 2 14 2 13 2 7 29 7 1
1 6 2 12 2 14 2 13 2 7 0 7 1
1 6 2 12 2 14 2 13 2 7 0 7 1
1 4 2 4 2 4 2 4 2 2 5 2 1
1 0 0 0 0 0 2 0 0 0 0 0 1
1 4 2 2 5 2 2 2 5 2 2 4 1
1 17 2 0 0 0 0 0 0 0 2 16 1
1 51 2 0 2 2 2 2 2 0 2 51 1
1 52 2 0 2 22 -2 -1 2 0 2 53 1
1 2 2 3 2 6 0 6 2 3 2 2 1
1 11 0 0 0 0 0 0 0 0 0 0 1
1 1 1 1 1 1 1 1 1 1 1 1 1